//Title Screen
tapToPlayText = TAP ANYWHERE\nTO PLAY
achievementsText = achievements
creditsText = credits
leaderboardsText = leaderboards
missionsText = missions
shortMusicText = M
shortSoundText = S
privacyStatementButtonText = privacy\nstatement
shopText = SHOP
onText = on
offText = off

//Game Over Screen
retryButtonText = dive again
depthText = DEPTH
foundText = YOU COLLECTED
shareText = SHARE
leaderboardsText = LEADERBOARDS
missionsText = MISSIONS

//Pause Screen
friendMarkersText = friend markers
musicText = music
soundText = sound
pauseText = paused
resumeText = resume
retryText = retry
noText = no
yesText = yes
warningText1 = warning
warningText2 = YOUR CURRENT\nPROGRESS WILL\nBE LOST!!\n\nARE YOU SURE\nYOU WANT\nTO EXIT?

//Shop Screen
playButtonText = play
freeStuffText = free stuff\ncoming soon
freeStuffButtonText = FREE
pearlsCoinsButtonText = pearls\n& coins
upgradesButtonText = UPGRADES

//Upgrades
headStartName = HEAD START
headStartDescription = Fast travel 500m. You have {0} left.
megaHeadStartName = MEGA HEAD START
megaHeadStartDescription = Fast travel 750m. You have {0} left.
shieldName = SHIELD
shieldDescription1 = Activate shield for protection.
shieldDescription2 = Activate 2 shields.
shieldDescription3 = Activate 3 shields.
spawnMoreFrequentlyText = Spawn more frequently.
megaCoinName = MORE MEGA COINS
airTankDescription = Lose less air from damage.
moreAirDescription = Get more air from air bubbles.
boostName = BOOST
boostDescription1 = Activate boost. Dive 50m.
boostDescription2 = Boost for 100m.
boostDescription3 = Boost for 150m.
coinMagnetName = COIN MAGNETS
coinMagnetDescription = Activate coin magnet.
coinMagnetDescription2 = Upgrade coin magnet strength.
maxedOutUpgrade = -

//pearls & coins
doubleCoinsName = DOUBLE COINS
doubleCoinsDescription = Collect twice as many coins!
stackOfCoinsName = STACK OF COINS
stackOfCoinsDescription = 20,000 coins
pileOfCoinsName = PILE OF COINS
pileOfCoinsDescription = 50,000 coins
bagOfCoinsName = BAG OF COINS
bagOfCoinsDescription = 100,000 coins
chestOfCoinsName = CHEST OF COINS
chestOfCoinsDescription = 250,000 coins
ultimatePackName = ULTIMATE PACK
ultimatePackDescription = 1,000,000 coins
bunchOfPearlsName = BUNCH OF PEARLS
bunchOfPearlsDescription = 25 pearls
heapOfPearlsName = HEAP OF PEARLS
heapOfPearlsDescription = 110 pearls
sackOfPearlsName = SACK OF PEARLS
sackOfPearlsDescription = 300 pearls

//Save Me Popup
saveMeText = save me!